2

0 0 0 1 7 7 4 0 0 0
0 1 1 1 7 7 4 4 4 0
1 1 1 1 7 7 1 4 4 4
1 1 1 1 7 7 1 1 1 1
1 1 1 1 7 7 1 1 1 1
7 7 7 7 7 7 1 1 1 1
7 7 7 7 7 4 3 3 4 4
1 1 1 1 1 4 3 3 4 4
0 1 1 1 1 4 4 4 4 0
0 0 0 1 1 1 1 0 0 0

0 0 0 0 0 0 2 0 0 0
0 0 0 0 0 0 2 2 2 0
0 0 0 0 0 0 0 2 2 2
0 0 0 0 0 0 0 0 0 0
0 0 0 0 0 2 0 0 0 0
0 0 0 0 0 0 0 0 0 0
0 0 0 0 0 0 0 0 0 0
0 0 0 0 0 0 0 0 0 0
0 0 0 0 0 0 0 0 0 0
0 0 0 0 0 0 0 0 0 0